"filename", "language", "C#", "comment", "blank", "total"
"f:\unity\Minesweeper\Assets\Scripts\Core\CellState.cs", "C#", 82, 2, 12, 96
"f:\unity\Minesweeper\Assets\Scripts\Core\Effects\SummonEffect.cs", "C#", 28, -1, 10, 37
"f:\unity\Minesweeper\Assets\Scripts\Core\Events\GameEvents.cs", "C#", 5, 0, 1, 6
"f:\unity\Minesweeper\Assets\Scripts\Core\Input\InputManager.cs", "C#", 14, 0, 0, 14
"f:\unity\Minesweeper\Assets\Scripts\Core\Input\InteractionHandler.cs", "C#", 50, 0, 4, 54
"f:\unity\Minesweeper\Assets\Scripts\Core\Mines\Implementation\MineEventHandler.cs", "C#", -1, 0, 0, -1
"f:\unity\Minesweeper\Assets\Scripts\Core\Mines\Mines\DisguisedMonsterMine.cs", "C#", 9, 4, 2, 15
"f:\unity\Minesweeper\Assets\Scripts\Core\Mines\Mines\MonsterMine.cs", "C#", 29, 10, 5, 44
"f:\unity\Minesweeper\Assets\Scripts\Core\Mines\Mines\MonsterType.cs", "C#", 8, 0, 0, 8
"f:\unity\Minesweeper\Assets\Scripts\Core\RPGMinesweeperTypes.cs", "C#", 16, 0, 3, 19
"f:\unity\Minesweeper\Assets\Scripts\Interfaces\ICellData.cs", "C#", 17, 4, 1, 22
"f:\unity\Minesweeper\Assets\Scripts\Interfaces\ICellStateModifier.cs", "C#", 14, 4, 1, 19
"f:\unity\Minesweeper\Assets\Scripts\Interfaces\ICellVisualUpdater.cs", "C#", 11, 4, 1, 16
"f:\unity\Minesweeper\Assets\Scripts\Managers\GridManager.cs", "C#", 32, 0, 3, 35
"f:\unity\Minesweeper\Assets\Scripts\ScriptableObjects\MarkPanelDisplayConfig.cs", "C#", 66, 5, 12, 83
"f:\unity\Minesweeper\Assets\Scripts\UI\Components\MarkPanel.cs", "C#", 282, 33, 59, 374
"f:\unity\Minesweeper\Assets\Scripts\Views\CellDisplayConfig.cs", "C#", 41, 4, 10, 55
"f:\unity\Minesweeper\Assets\Scripts\Views\CellInteractionHandler.cs", "C#", 133, 1, 24, 158
"f:\unity\Minesweeper\Assets\Scripts\Views\CellView.cs", "C#", -72, 7, 5, -60
"f:\unity\Minesweeper\Assets\Scripts\Views\CellVisualizer.cs", "C#", 389, 43, 63, 495
"f:\unity\Minesweeper\Assets\Scripts\Views\DisguisedMonsterMineDisplayStrategy.cs", "C#", -244, -26, -40, -310
"f:\unity\Minesweeper\Assets\Scripts\Views\DisplayStrategies\DisguisedMonsterMineDisplayStrategy.cs", "C#", 244, 26, 40, 310
"f:\unity\Minesweeper\Assets\Scripts\Views\DisplayStrategies\IMineDisplayStrategy.cs", "C#", 8, 0, 1, 9
"f:\unity\Minesweeper\Assets\Scripts\Views\DisplayStrategies\MonsterMineDisplayStrategy.cs", "C#", 213, 8, 48, 269
"f:\unity\Minesweeper\Assets\Scripts\Views\DisplayStrategies\StandardMineDisplayStrategy.cs", "C#", 38, 2, 6, 46
"f:\unity\Minesweeper\Assets\Scripts\Views\IMineDisplayStrategy.cs", "C#", -8, 0, -1, -9
"f:\unity\Minesweeper\Assets\Scripts\Views\MineDisplayStrategyFactory.cs", "C#", 23, 2, 2, 27
"f:\unity\Minesweeper\Assets\Scripts\Views\MonsterMineDisplayStrategy.cs", "C#", -144, -10, -23, -177
"f:\unity\Minesweeper\Assets\Scripts\Views\StandardMineDisplayStrategy.cs", "C#", -38, -2, -6, -46
"Total", "-", 1245, 120, 243, 1608